13 13
#############
..#.........#
#.#######.###
#...#...#.#.#
###.#.#.###.#
#.#.#.#.....#
#.#.#.#######
#...#.......#
#.#########.#
#.#.........#
#.#.#######.#
#...#........
#############